
Name. 	Residence. 	Condition of discharge.

Rogers, Lem. . 	Fayette County, Va. . 	Released on oath and bond.

Ruckman, M. D. . 	Randolph County, Va. . 	Do.

Rudolph, Hezekiah. . 	Hamsphire County, Va. . 	Released on oath.

Robinson, J. H. . 	Wirt County, Va. . 	Do.

Rhea, J. L. . 	Braxton County, Va. . 	Do.

Ryan, G. M. . 	Virginia. . 	Do.

Rose, Solomon. . 	. . do. . 	Do.

Rafferty, Patrick. . 	Calhoun County, Va. . 	Do.

Roach, John. . 	Roane County, Va. . 	Do.

Rinehart, Elijah. . 	Hampshire County, Va. . 	Do.

Ruby John. . 	Putnam County, Va. . 	Released on oath and bond.

Smith, Chris. H. . 	Harrison County, Va. . 	Do.

Stalnaker, Absolom. . 	Randolph County, Va. . 	Do.

Schackelford, Cobb. . 	Nicholas County, Va. . 	Released on oath.

Smith, E. A. . 	Cabell County, Va. . 	Do.

Stewart, James. . 	. . do. . 	Do.

Snyder, Lewis. . 	Lewis County, Va. . 	Do.

Smoot, N. C. . 	Hampshire County, Va. . 	Do.

Stackhouse, M. . 	Roane County, Va. . 	Do.

Siebert, Adam. . 	Hampshire County, Va. . 	Do.

Siebert, William. . 	. . do. . 	Do.

Stockaslader, Daniel. . 	. . do. . 	Do.

Strickland, Joseph. . 	Virginia. . 	Do.

Sheppard, Martin. . 	Wirt County, Va. . 	Do.

Staats, William. . 	Roane County, Va. .

Somerville, David. . 	Wirt County, Va. . 	Do.

Stewart, William P. . 	Roane County, Va. . 	Do.

Stewart, John W. . 	. . do. . 	Do.

Sharp, Bryerly. . 	Wirt County, Va. . 	Released on oath and to live in Ohio.

Sheppard, R. M. J. . 	Virginia. . 	Released on oath.

Stallman, G. W. . 	Gilmer County, Va. . 	Released on oath and bond.

Starcher, Philip. . 	Virginia. . 	Do.

Starcher, A. J. . 	. . do. . 	Do.

Tanneackson County, Va. . 	Do.

Ware, John N. . 	Randolph County, Va. . 	Do.

Wilson, Wash. M. . 	Clay County, Va. . 	Released on oath.

Warner, E. C. . 	Braxton County, Va. . 	Released on oath and bond.

Windsor, Anderson. . 	Fayette County, Va. . 	Do.

Walton, E. H. . 	Cabell County, Va. . 	Do.

Wise, W. H. . 	Harrison County, Va. . 	Released on oath.

Ward, McKinsey. . 	Barbour County, Va. . 	Do.

Wyatt, Addison. . 	Lewis County, Va. . 	Do.

Wagoner, Michael. . 	Virginia. . 	Do.

Youst, F. H. . 	Marion County, Va. . 	Do.

The following prisoners under indictment for treason have been turned over to the U. S. marshal for the western district of Virginia.

Milton J. Ferguson, Robert S. Holderby, A. C. Kennedy, John New comb, James M. Gray, James H. Nay, William Bennett, W. C. Rodgers William Hamilton, David H. Gilmer, George Bastable, Nathan Liggett. John R. Hodges, John D. Mayo, Jeff. Bowen, sr., James E. Bowen, Mott. Jewell, William Curry, Benjamin France, Lewis Ekuss, Joseph Harbour, Greenwood childers, Lewis Childers, George W. Savage, Samuel Smith, John L. Bowen, Perry Peyton, Thomas Scales, M. W. Hughes, P. H. Thomasson, Daniel Dusky, Kellis Argobright, Jesse J. Ingraham, Hurston Spurlock, James E. Smith, Stephen Strather, sr.

JOSEPH DARR,

Major First Virginia Cavalry, Provost-Marshal.

